.......0S.
...00...0.
..0.0.....
..0.0.0...
0.........
0..0......
.0.....0..
..0..0....
..........
....0....F